50 30
00000000000000000000000000000000000000000000000000
01111111111111111111111111110111111111111111111110
01111111111111111111111111110111111111111111111110
01111111111111111111111111110111111111111111111110
01111111111111111111111111110111111111111111111110
01111111111111111111111111110111111111111111111110
01111111111111111111111111110111111111111111111110
01111111111111111111111111110111111111111111111110
01111111111111111111111111110111111111111111111110
01111111111111111111111111110111111111111111111110
01111111111111111111111111110111111111111111111110
01111111111111111111111111110111111111111111111110
01111111111111111111111111110111111111111111111110
01111111100000000001111111110111111111011111111110
01111111111111111101111111111111111111011111111110
01111111111111111101111111111111111111011111111110
01111111111111111101111111111111111111011111111110
01111111111111111101111111111111111111011111111110
01111111111111111101111111111111111111011111111110
01111111111111111101111111111111111111011111111110
01111111111111111101111111111111111111011111111110
01111111111111111101111111111111111111011111111110
01111111111111111101111111111111111111011111111110
01111111111111111101111111111111111111011111111110
01111111111111111101111111111111111111011111111110
01111111111111111101111111111111111111011111111110
01111111111111111101111111111111111111011111111110
01111111111111111101111111111111111111011111111110
00000000000000000000000000000000000000000000000000